20 20 2
0.3 49.3
17 13
5 6 1 1
5 17 1 1
....................
....................
~~~~~~~~~...........
~~~~~~~~~~~~~~~.....
~~~~~~~~~~~~~~~~~...
~~~~~~~~~~~~~~~~~~..
~~~~~~~~~~~~~~~~~~~.
~~~~~~~~~~~~~~~~~~~~
~~~~~~~~~~~~~~~~~~~~
~~~~~~~~~~~~~~~~~~~~
~~~~~~~~~~~~~~~~~~~~
~~~~~~~~...~~~~~~~~~
~~~~~~~~......~~~~~~
~~~~~~~~.....~~~~~~~
~~~~~~~~~...~~~~~~~~
~~~~~~~~~..~~~~~~~~~
~~~~~~~~~~~~~~~~~~~~
~~~~~~~~~~~~~~~~~~~~
~~~~~~~~~~~~~~~~~~~~
~~~~~~~~~~~~~~~~~~~~
